........
........
...#O#..
...UUO..
...UUO..
...UUO..
...UUO..
.#UUUO..
.OUUUO..
.OUUUUU#
.OUUUUUO
.#OOOOO#
