........
........
...#O#..
...O.O..
...O.O..
...O.O..
...O.O..
.#O#.O..
.O...O..
.O...#O#
.O.....O
.#OOOOO#
